R 1280 720
NO ./textures/alice.xpm
SO ./textures/alice.xpm
WE ./textures/alice.xpm
EA ./textures/alice.xpm
S ./textures/alice.xpm
SK ./textures/alice.xpm
F ./textures/alice.xpm
P ./sprites/portal.xpm
M ./music/great_wall.mp3
111111111111111111111111
100000000000000000000001
100000000000000000000001
100000000000200000011111
10000011111000010101
10000010001000000001
100000102010000102011111
100000100010000000000001
100000110110000101010001
100000000000200000000001
100000000000000000000001
100200020N00200000002001
100000000000000000000001
100000000000200000000001
100000000000000000000001
100000000000200000000001
111111111000000000000001
110100001000000111111111
1100002010000001
1101000010000001
1101111110000001111
1100000000000000001
1111111110000000001
1111111111111111111
