R 1280 720
NO ./textures/metro.xpm
SO ./textures/bricks.xpm
WE ./textures/wood.xpm
EA ./textures/wallpaper.xpm
C 153,153,255
F 153,51,51
S ./sprites/pine.xpm
1111111111111111111111111
1000000000110000000000001
1011000001110000002000001
1001000000000000000000001
1011000001110000000000001
10000000001100000111011111111
11110111111111011100000000001
11110111  100011101010010001
11000001  101011100000000001
10002000110000001100000010001
100000N0000000001101010010001
 100000111010101111101111000111
  1101111110101  101111010001
   111111111111  111111111111
