R 1280 720
NO ./textures/metro.xpm
SO ./textures/bricks.xpm
WE ./textures/wood.xpm
EA ./textures/wallpaper.xpm
S ./sprites/pine.xpm
F 153,51,51
C 153,153,255
11111111111111111111
10000000000000000001
10111111111111111101
10100000000000000101
10101111111111110101
10101000000000010101
10101011111111010101
10101010000001010101
10101010111101010101
10101010100101010101
1010101010N101010101
10101010101101010101
10101010100001010101
10101010111111010101
10101010000000010101
10101011111111110101
10101000000000000101
10101111111111111101
12100000000000000001
11111111111111111111
