R 1280 720
NO ./textures/metro.xpm
SO ./textures/bricks.xpm
WE ./textures/wood.xpm
EA ./textures/wallpaper.xpm
C 153,153,255
F 153,51,51
S ./sprites/pine.xpm
        11111
      110000011
    1100000000011
   100000000000001
  10000000000000001
 1000000000000000001
 1000110000000110001
100001100000001100001
100000000000000000001
100000000000000000001
1000000000S0000000001
100000000000000000001
 1000200000000020001
 100002000000020001
  1000022222220001
   100000000000001
    1100000000011
      110000011
        11111
