R 1280 720
NO ./textures/metro.xpm
SO ./textures/bricks.xpm
WE ./textures/wood.xpm
EA ./textures/wallpaper.xpm
S ./sprites/pine.xpm
SK ./textures/sky.xpm
F ./textures/grass.xpm
P ./sprites/portal.xpm
M ./music/guile.mp3
1
11
101
1001
10001
100001
1030001
10000001
100030001
1000000001
10000000001
100000020001
1003000000001
10000000000001
100000000020001
1030000000000001
10000000000000001
1002000N0000020001
1000000000200000201
11111111111111111111
