R 1280 720
NO ./textures/metro.xpm
SO ./textures/bricks.xpm
WE ./textures/wood.xpm
EA ./textures/wallpaper.xpm
S ./sprites/pine.xpm
F 153,51,51
C 153,153,255
1
11
101
1001
10001
100001
1020001
10000001
100020001
1000000001
10000000001
100000020001
1002000000001
10000000000001
100000000020001
1020000000000001
10000000000000001
1002000N0000020001
1000000000200000201
11111111111111111111
