R 1280 720
NO ./textures/metro.xpm
SO ./textures/bricks.xpm
WE ./textures/wood.xpm
EA ./textures/wallpaper.xpm
S ./sprites/pine.xpm
SK ./textures/sky.xpm
F ./textures/grass.xpm
P ./sprites/portal.xpm
M ./music/guile.mp3
1
1 1
1 0 1
1 0 0 1
1 0 0 0 1
1 0 0 0 0 1
1 0 3 0 0 0 1
1 0 0 0 0 0 0 1
1 0 0 0 3 0 0 0 1
1 0 0 0 0 0 0 0 0 1
1 0 0 0 0 0 0 0 0 0 1
1 0 0 0 0 0 0 2 0 0 0 1
1 0 0 3 0 0 0 0 0 0 0 0 1
1 0 0 0 0 0 0 0 0 0 0 0 0 1
1 0 0 0 0 0 0 0 0 0 2 0 0 0 1
1 0 3 0 0 0 0 0 0 0 0 0 0 0 0 1
1 0 0 0 0 0 0 0 0 0 0 0 0 0 0 0 1
1 0 0 2 0 0 0 N 0 0 0 0 0 2 0 0 0 1
1 0 0 0 0 0 0 0 0 0 2 0 0 0 0 0 2 0 1
1 1 1 1 1 1 1 1 1 1 1 1 1 1 1 1 1 1 1 1
