R 1280 720
NO ./textures/eagle_wolf.xpm
SO ./textures/redbrick_wolf.xpm
WE ./textures/greystone_wolf.xpm
EA ./textures/wood_wolf.xpm
S ./sprites/barrel_wolf.xpm
SK ./textures/purplestone_wolf.xpm
F ./textures/colorstone_wolf.xpm
P ./sprites/portal.xpm
M ./music/pacific_rim.mp3
11111111111111111111
100000000000000000001
1000000000000000000001
10030000000020000001111
10000011111000010101
10000010001000000001
100000102010000102011111
100000100010000000000001
100000110110000101010001
111110000000200000000001
    10000000000000300001
    10020N00200000002001
    10000000000000000001
   100300000200000000001
  1000000000000003000001
 10000000000200000000001
111111111000000000000001
110100001000000111111111
1100302010000001
1101000010000001
1101111110030001111
1100000000000000001
1111111110000000001
1111111111111111111
